115,115,115,115,115,115,115,115,115,115
115,134,134,134,134,134,134,134,134,134
115,134,16,16,16,137,138,139,16,16
115,134,16,115,16,153,154,155,36,36
115,134,36,36,36,119,120,121,36,36
115,134,36,36,36,36,16,36,36,36
115,134,16,115,36,36,16,16,16,16
115,134,16,16,36,36,36,36,36,36
115,134,16,137,138,138,138,139,16,16

